####################
#..................#
#..................#
#..................#
#..................#
#..................#
#..................#
#..................#
#..................#
#..................#
#........SS........#
#..................#
#..................#
#..................#
#..................#
#..................#
#..................#
#..................#
#..................#
####################