####################
#..................#
#..................#
#..................#
#..................#
#..................#
#..................#
#..................#
#..................#
#..................#
#..S.....S...A.....#
#..................#
#..................#
#..................#
#..................#
#........H.........#
#..................#
#..................#
#..................#
####################