####################
#..................#
#........S.........#
#.............#....#
#.....#########....#
#..................#
#..........H...#...#
####...###...###...#
#......#...........#
#......#...........#
#......#...####....#
#.............###..#
#####.....H...#....#
#..................#
#.........#........#
#.....########.....#
#..................#
#........S......A..#
#..................#
####################