####################
#..................#
#..S......A........#
#.............#....#
#.........#####....#
#.........#........#
#..........H...#...#
####.........###...#
#..............#...#
#......#...........#
#......#...####....#
#.............#....#
#####.....H...#....#
#..................#
#.........#........#
#..................#
#...A..............#
#............S.....#
#..................#
####################